0000 0000 0000 0000 0000 0000 0000 0000 0000 0000 0000 0000 0000 0000 0000 0000 0000 0000 0000 0000 0000 0000 0000 0000 0000 0000 0000 0000 0000 0000 0000 0000 0000 0000 0000 0000 0000 0000 0000 0000 0000 0000 0000 0000 0000 0000 0000 0000 0000
0000 0000 0000 0000 0000 0000 0000 0000 0000 0000 0000 0000 0000 0000 0000 0000 0000 0000 0000 0000 0000 0000 0000 0000 0000 0000 0000 0000 0000 0000 0000 0000 0000 0000 0000 0000 0000 0000 0000 0000 0000 0000 0000 0000 0000 0000 0000 0000 0000
0000 0000 0000 0000 0000 0000 0000 0000 0000 0000 0000 0000 0000 0000 0000 0000 0000 0000 0000 0000 0000 0000 0000 0000 0000 0000 0000 0000 0000 0000 0000 0000 0000 0000 0000 0000 0000 0000 0000 0000 0000 0000 0000 0000 0000 0000 0000 0000 0000
0000 0000 0000 0000 0000 0000 0000 0000 0000 0000 0000 0000 0000 0000 0000 0000 0000 0000 0000 0000 0000 0000 0000 0000 0000 0000 0000 0000 0000 0000 0000 0000 0000 0000 0000 0000 0000 0000 0000 0000 0000 0000 0000 0000 0000 0000 0000 0000 0000
0000 0000 0000 0000 0000 0000 0000 0000 0000 0000 0000 0000 0000 0000 0000 0000 0000 0000 0000 0000 0000 0000 0000 0000 0000 0000 0000 0000 0000 0000 0000 0000 0000 0000 0000 0000 0000 0000 0000 0000 0000 0000 0000 0000 0000 0000 0000 0000 0000
0000 0000 0000 0000 0000 0000 0000 0000 0000 0000 0000 0000 0000 0000 0000 0000 0000 0000 0000 0000 0000 0000 0000 0000 0000 0000 0000 0000 0000 0000 0000 0000 0000 0000 0000 0000 0000 0000 0000 0000 0000 0000 0000 0000 0000 0000 0000 0000 0000
0000 0000 0000 0000 0000 3012 3012 3012 3012 3012 3012 3012 3012 3012 3012 3012 3012 3012 3012 3012 3012 3012 3012 3012 3012 3012 3012 3012 3012 3012 3012 3012 3012 3012 3012 3012 3012 3012 3012 3012 3012 3012 0000 0000 0000 0000 0000 0000 0000
0000 0000 0000 0000 0000 3012 3011 3011 3011 3011 3011 3011 3011 3011 3011 3011 3011 3011 3011 3011 3011 3011 3011 3011 3011 3011 3011 3011 3011 3011 3011 3011 3011 3011 3011 3011 3011 3011 3011 3011 3011 3012 0000 0000 0000 0000 0000 0000 0000
0000 0000 0000 0000 0000 3012 3011 3011 3011 3011 3011 3011 3011 3011 3011 3011 3011 3011 3011 3011 3011 3011 3011 3011 3011 3011 3011 3011 3011 3011 3011 3011 3011 3011 3011 3011 3011 3011 3011 3011 3011 3012 0000 0000 0000 0000 0000 0000 0000
0000 0000 0000 0000 0000 3012 3011 3011 3011 3011 3011 3011 3011 3011 3011 3011 3011 3011 3011 3011 3011 3011 3011 3011 3011 3011 3011 3011 3011 3011 3011 3011 3011 3011 3011 3011 3011 3011 3011 3011 3011 3012 0000 0000 0000 0000 0000 0000 0000
0000 0000 0000 0000 0000 3012 3011 3011 3011 3011 3011 3011 3011 3011 3011 3011 3011 3011 3011 3011 3011 3011 3011 3011 3011 3011 3011 3011 3011 3011 3011 3011 3011 3011 3011 3011 3011 3011 3011 3011 3011 3012 0000 0000 0000 0000 0000 0000 0000
0000 0000 0000 0000 0000 3012 3011 3011 3011 3011 3011 3011 3011 3011 3011 3011 3011 3011 3011 3011 3011 3011 3011 3011 3011 3011 3011 3011 3011 3011 3011 3011 3011 3011 3011 3011 3011 3011 3011 3011 3011 3012 0000 0000 0000 0000 0000 0000 0000
0000 0000 0000 0000 0000 3012 3011 3011 3011 3011 3011 3011 3011 3011 3011 3011 3011 3011 3011 3011 3011 3011 3011 3011 3011 3011 3011 3011 3011 3011 3011 3011 3011 3011 3011 3011 3011 3011 3011 3011 3011 3012 0000 0000 0000 0000 0000 0000 0000
0000 0000 0000 0000 0000 3012 3011 3011 3011 3011 3011 3011 3011 3011 3011 3011 3011 3011 3011 3011 3011 3011 3011 3011 3011 3011 3011 3011 3011 3011 3011 3011 3011 3011 3011 3011 3011 3011 3011 3011 3011 3012 0000 0000 0000 0000 0000 0000 0000
0000 0000 0000 0000 0000 3012 3011 3011 3011 3011 3011 3011 3011 3011 3011 3011 3011 3011 3011 3011 3011 3011 3011 3011 3011 3011 3011 3011 3011 3011 3011 3011 3011 3011 3011 3011 3011 3011 3011 3011 3011 3012 0000 0000 0000 0000 0000 0000 0000
0000 0000 0000 0000 0000 3012 3011 3011 3011 3011 3011 3011 3011 3011 3017 3011 3011 3011 3011 3011 3011 3011 3011 3011 3011 3011 3011 3011 3011 3011 3011 3011 3011 3011 3011 3011 3011 3011 3011 3011 3011 3012 0000 0000 0000 0000 0000 0000 0000
0000 0000 0000 0000 0000 3012 3011 3011 3011 3011 3011 3011 3011 3011 3011 3011 3011 3011 3011 3011 3011 3011 3011 3011 3011 3011 3011 3011 3011 3011 3011 3011 3011 3011 3011 3011 3011 3011 3011 3011 3011 3012 0000 0000 0000 0000 0000 0000 0000
0000 0000 0000 0000 0000 3012 3011 3011 3011 3011 3011 3011 3011 3011 3011 3011 3011 3011 3011 3011 3011 3011 3011 3011 3011 3011 3011 3011 3011 3011 3011 3011 3011 3011 3011 3011 3011 3011 3011 3011 3011 3012 0000 0000 0000 0000 0000 0000 0000
0000 0000 0000 0000 0000 3012 3011 3011 3011 3011 3011 3011 3011 3011 3011 3011 3011 3011 3011 3011 3011 3011 3011 3011 3011 3011 3011 3011 3011 3011 3011 3011 3011 3011 3011 3011 3011 3011 3011 3011 3011 3012 0000 0000 0000 0000 0000 0000 0000
0000 0000 0000 0000 0000 3012 3011 3011 3011 3011 3011 3011 3011 3011 3011 3011 3011 3011 3011 3011 3011 3011 3011 3011 3011 3011 3011 3011 3011 3011 3011 3011 3011 3011 3011 3011 3011 3011 3011 3011 3011 3012 0000 0000 0000 0000 0000 0000 0000
0000 0000 0000 0000 0000 3012 3011 3011 3011 3011 3011 3011 3011 3011 3011 3011 3011 3011 3011 3011 3011 3011 3011 3011 3011 3011 3011 3011 3011 3011 3011 3011 3011 3011 3011 3011 3011 3011 3011 3011 3011 3012 0000 0000 0000 0000 0000 0000 0000
0000 0000 0000 0000 0000 3012 3011 3011 3011 3011 3011 3011 3011 3011 3011 3011 3011 3011 3011 3011 3011 3011 3011 3011 3011 3011 3011 3011 3011 3011 3011 3011 3011 3011 3011 3011 3011 3011 3011 3011 3011 3012 0000 0000 0000 0000 0000 0000 0000
0000 0000 0000 0000 0000 3012 3011 3011 3011 3011 3011 3011 3011 3011 3011 3011 3011 3011 3011 3011 3011 3011 3011 3011 3011 3011 3011 3011 3011 3011 3011 3011 3011 3011 3011 3011 3011 3011 3011 3011 3011 3012 0000 0000 0000 0000 0000 0000 0000
0000 0000 0000 0000 0000 3012 3011 3011 3011 3011 3011 3011 3011 3011 3011 3011 3011 3011 3011 3011 3011 3011 3011 3011 3011 3011 3011 3011 3011 3011 3011 3011 3011 3011 3011 3011 3011 3011 3011 3011 3011 3012 0000 0000 0000 0000 0000 0000 0000
0000 0000 0000 0000 0000 3012 3011 3011 3011 3011 3011 3011 3011 3011 3011 3011 3011 3011 3011 3011 3011 3011 3011 3011 3011 3011 3011 3011 3011 3011 3011 3011 3011 3011 3011 3011 3011 3011 3011 3011 3011 3012 0000 0000 0000 0000 0000 0000 0000
0000 0000 0000 0000 0000 3012 3011 3011 3011 3011 3011 3011 3011 3011 3011 3011 3011 3011 3011 3011 3011 3011 3011 3011 3011 3011 3011 3011 3011 3011 3011 3011 3011 3011 3011 3011 3011 3011 3011 3011 3011 3012 0000 0000 0000 0000 0000 0000 0000
0000 0000 0000 0000 0000 3012 3011 3011 3011 3011 3011 3011 3011 3011 3011 3011 3011 3011 3011 3011 3011 3011 3011 3011 3011 3011 3011 3011 3011 3011 3011 3011 3011 3011 3011 3011 3011 3011 3011 3011 3011 3012 0000 0000 0000 0000 0000 0000 0000
0000 0000 0000 0000 0000 3012 3011 3011 3011 3011 3011 3011 3011 3011 3011 3011 3011 3011 3011 3011 3011 3011 3011 3011 3011 3011 3011 3011 3011 3011 3011 3011 3011 3011 3011 3011 3011 3011 3011 3011 3011 3012 0000 0000 0000 0000 0000 0000 0000
0000 0000 0000 0000 0000 3012 3011 3011 3011 3011 3011 3011 3011 3011 3011 3011 3011 3011 3011 3011 3011 3011 3011 3011 3011 3011 3011 3011 3011 3011 3011 3011 3011 3011 3011 3011 3011 3011 3011 3011 3011 3012 0000 0000 0000 0000 0000 0000 0000
0000 0000 0000 0000 0000 3012 3011 3011 3011 3011 3011 3011 3011 3011 3011 3011 3011 3011 3011 3011 3011 3011 3011 3011 3011 3011 3011 3011 3011 3011 3011 3011 3011 3011 3011 3011 3011 3011 3011 3011 3011 3012 0000 0000 0000 0000 0000 0000 0000
0000 0000 0000 0000 0000 3012 3011 3011 3011 3011 3011 3011 3011 3011 3011 3011 3011 3011 3011 3011 3011 3011 3011 3011 3011 3011 3011 3011 3011 3011 3011 3011 3011 3011 3011 3011 3011 3011 3011 3011 3011 3012 0000 0000 0000 0000 0000 0000 0000
0000 0000 0000 0000 0000 3012 3011 3011 3011 3011 3011 3011 3011 3011 3011 3011 3011 3011 3011 3011 3011 3011 3011 3011 3011 3011 3011 3011 3011 3011 3011 3011 3011 3011 3011 3011 3011 3011 3011 3011 3011 3012 0000 0000 0000 0000 0000 0000 0000
0000 0000 0000 0000 0000 3012 3011 3011 3011 3011 3011 3011 3011 3011 3011 3011 3011 3011 3011 3011 3011 3011 3011 3011 3011 3011 3011 3011 3011 3011 3011 3011 3011 3011 3011 3011 3011 3011 3011 3011 3011 3012 0000 0000 0000 0000 0000 0000 0000
0000 0000 0000 0000 0000 3012 3011 3011 3011 3011 3011 3011 3011 3011 3011 3011 3011 3011 3011 3011 3011 3011 3011 3011 3011 3011 3011 3011 3011 3011 3011 3011 3011 3011 3011 3011 3011 3011 3011 3011 3011 3012 0000 0000 0000 0000 0000 0000 0000
0000 0000 0000 0000 0000 3012 3011 3011 3011 3011 3011 3011 3011 3011 3011 3011 3011 3011 3011 3011 3011 3011 3011 3011 3011 3011 3011 3011 3011 3011 3011 3011 3011 3011 3011 3011 3011 3011 3011 3011 3011 3012 0000 0000 0000 0000 0000 0000 0000
0000 0000 0000 0000 0000 3012 3011 3011 3011 3011 3011 3011 3011 3011 3011 3011 3011 3011 3011 3011 3011 3011 3011 3011 3011 3011 3011 3011 3011 3011 3011 3011 3011 3011 3011 3011 3011 3011 3011 3011 3011 3012 0000 0000 0000 0000 0000 0000 0000
0000 0000 0000 0000 0000 3012 3011 3011 3011 3011 3011 3011 3011 3011 3011 3011 3011 3011 3011 3011 3011 3011 3011 3011 3011 3011 3011 3011 3011 3011 3011 3011 3011 3011 3011 3011 3011 3011 3011 3011 3011 3012 0000 0000 0000 0000 0000 0000 0000
0000 0000 0000 0000 0000 3012 3011 3011 3011 3011 3011 3011 3011 3011 3011 3011 3011 3011 3011 3011 3011 3011 3011 3011 3011 3011 3011 3011 3011 3011 3011 3011 3011 3011 3011 3011 3011 3011 3011 3011 3011 3012 0000 0000 0000 0000 0000 0000 0000
0000 0000 0000 0000 0000 3012 3011 3011 3011 3011 3011 3011 3011 3011 3011 3011 3011 3011 3011 3011 3011 3011 3011 3011 3011 3011 3011 3011 3011 3011 3011 3011 3011 3011 3011 3011 3011 3011 3011 3011 3011 3012 0000 0000 0000 0000 0000 0000 0000
0000 0000 0000 0000 0000 3012 3012 3012 3012 3012 3012 3012 3012 3012 3012 3012 3012 3012 3012 3012 3012 3012 3012 3012 3012 3012 3012 3012 3012 3012 3012 3012 3012 3012 3012 3012 3012 3012 3012 3012 3012 3012 0000 0000 0000 0000 0000 0000 0000
0000 0000 0000 0000 0000 0000 0000 0000 0000 0000 0000 0000 0000 0000 0000 0000 0000 0000 0000 0000 0000 0000 0000 0000 0000 0000 0000 0000 0000 0000 0000 0000 0000 0000 0000 0000 0000 0000 0000 0000 0000 0000 0000 0000 0000 0000 0000 0000 0000
0000 0000 0000 0000 0000 0000 0000 0000 0000 0000 0000 0000 0000 0000 0000 0000 0000 0000 0000 0000 0000 0000 0000 0000 0000 0000 0000 0000 0000 0000 0000 0000 0000 0000 0000 0000 0000 0000 0000 0000 0000 0000 0000 0000 0000 0000 0000 0000 0000
0000 0000 0000 0000 0000 0000 0000 0000 0000 0000 0000 0000 0000 0000 0000 0000 0000 0000 0000 0000 0000 0000 0000 0000 0000 0000 0000 0000 0000 0000 0000 0000 0000 0000 0000 0000 0000 0000 0000 0000 0000 0000 0000 0000 0000 0000 0000 0000 0000
0000 0000 0000 0000 0000 0000 0000 0000 0000 0000 0000 0000 0000 0000 0000 0000 0000 0000 0000 0000 0000 0000 0000 0000 0000 0000 0000 0000 0000 0000 0000 0000 0000 0000 0000 0000 0000 0000 0000 0000 0000 0000 0000 0000 0000 0000 0000 0000 0000
0000 0000 0000 0000 0000 0000 0000 0000 0000 0000 0000 0000 0000 0000 0000 0000 0000 0000 0000 0000 0000 0000 0000 0000 0000 0000 0000 0000 0000 0000 0000 0000 0000 0000 0000 0000 0000 0000 0000 0000 0000 0000 0000 0000 0000 0000 0000 0000 0000
0000 0000 0000 0000 0000 0000 0000 0000 0000 0000 0000 0000 0000 0000 0000 0000 0000 0000 0000 0000 0000 0000 0000 0000 0000 0000 0000 0000 0000 0000 0000 0000 0000 0000 0000 0000 0000 0000 0000 0000 0000 0000 0000 0000 0000 0000 0000 0000 0000
0000 0000 0000 0000 0000 0000 0000 0000 0000 0000 0000 0000 0000 0000 0000 0000 0000 0000 0000 0000 0000 0000 0000 0000 0000 0000 0000 0000 0000 0000 0000 0000 0000 0000 0000 0000 0000 0000 0000 0000 0000 0000 0000 0000 0000 0000 0000 0000 0000
0000 0000 0000 0000 0000 0000 0000 0000 0000 0000 0000 0000 0000 0000 0000 0000 0000 0000 0000 0000 0000 0000 0000 0000 0000 0000 0000 0000 0000 0000 0000 0000 0000 0000 0000 0000 0000 0000 0000 0000 0000 0000 0000 0000 0000 0000 0000 0000 0000
0000 0000 0000 0000 0000 0000 0000 0000 0000 0000 0000 0000 0000 0000 0000 0000 0000 0000 0000 0000 0000 0000 0000 0000 0000 0000 0000 0000 0000 0000 0000 0000 0000 0000 0000 0000 0000 0000 0000 0000 0000 0000 0000 0000 0000 0000 0000 0000 0000
