1111111111111111D111111111111111
1..............................1
1..............................1
1..............................1
1..............................1
1..............................1
1..............S...............1
1..............................1
1..............................1
1..............................1
1..............................1
11111111111111111111111111111111
