11111111111111111111111111111111
1..............................1
1..............................1
1..............................1
1..............................1
1..............................1
1..............................D
1..............................1
1..............................1
1..............................1
1..............................1
111111111111111D1111111111111111
