11111111111111111111111111111111
1..............................1
1..............................1
1..............................1
1..............................1
1..............................1
D..............................D
1..............................1
1..............................1
1..............................1
1..............................1
111111111111111D1111111111111111
